{
  "doodads": [
    {}
  ],
  "tiles": [
      "00  3          ",
      "00             ",
      "00             ",
      "00             ",
      "00             ",
      "00             ",
      "00             ",
      "00             ",
      "00         8   ",
      "00             ",
      "00             ",
      "007            ",
      "00             ",
      "00             ",
      "00             ",
      "00             ",

      "00 4 b         ",
      "00             ",
      "00             ",
      "00             ",
      "00   1      8  ",
      "00   b         ",
      "00   1   b     ",
      "005  b         ",
      "00   1         ",
      "00             ",
      "00             ",
      "00         a   ",
      "00             ",
      "00             ",
      "00             ",
      "00             "
  ]
}
